9
0 0 1 2 1 2 0 2 2 0 2 2 0 2 2
0 2 2 0 2 2 1 1 0 1 1 2 1 1 0
2 2 1 0 1 2 0 2 0 2 1 0 1 2 2
1 0 2 0 0 2 1 1 1 2 2 0 0 2 0
0 2 1 0 1 2 0 0 0 2 1 0 1 2 1
1 2 2 0 2 2 1 1 1 1 2 2 2 1 2
0 2 1 2 1 2 1 1 2 1 2 1 0 1 2
2 2 1 0 0 0 2 1 0 0 0 2 0 0 0
0 1 1 0 1 2 2 2 0 1 1 0 1 1 2
0 0 2 0 0 2 1 1 2 2 0 0 0 2 0
1 2 1 0 1 2 1 0 1 0 1 0 1 2 2
2 0 1 0 1 2 1 2 0 2 1 2 1 1 0
0 2 2 2 2 2 2 2 1 0 2 0 2 0 0
5,156,20
0 0 1 2 0 1 0 0 0 2 2 2 2 2 2
0 2 2 2 0 0 1 0 1 0 1 2 1 0 2
2 1 1 0 1 0 2 0 1 2 1 0 1 2 1
0 0 2 2 2 0 1 2 0 2 0 0 0 2 0
0 1 1 0 1 2 0 0 2 1 1 0 1 1 2
0 2 2 2 1 2 1 1 2 1 0 2 0 2 2
1 1 1 0 2 2 1 1 2 0 2 1 1 1 0
2 0 0 0 1 0 1 2 2 1 2 0 1 2 0
1 2 1 0 1 2 2 0 2 1 1 0 1 0 0
2 0 0 0 0 1 1 1 2 0 2 2 0 0 1
0 0 1 0 1 0 2 2 2 0 1 0 1 2 2
1 2 2 2 2 1 1 2 1 2 1 2 2 2 0
2 2 1 2 2 2 0 2 0 0 1 2 1 0 0
255,239,155
0 0 2 2 1 2 2 2 1 0 2 1 0 0 0
0 2 1 2 0 2 1 2 2 0 0 2 2 1 0
2 1 1 0 1 2 2 2 1 0 1 0 1 2 2
0 2 0 0 0 2 1 0 1 0 0 0 0 0 1
2 2 1 0 1 0 2 0 2 0 1 0 1 2 2
2 1 1 0 1 0 1 1 1 0 2 0 2 1 2
2 2 1 2 1 1 1 1 0 2 1 2 0 0 2
1 2 2 2 2 2 0 0 2 1 2 2 1 0 1
2 2 1 0 1 2 1 1 2 2 1 0 1 0 2
2 0 0 0 0 2 2 1 1 0 0 0 0 0 1
1 0 1 0 1 0 2 0 0 2 1 0 1 2 0
2 2 2 2 2 0 1 1 1 0 2 2 0 0 0
2 1 2 2 1 0 2 2 2 0 2 1 0 2 0
255,185,228
0 0 0 0 0 2 1 2 1 2 1 0 2 1 0
2 1 1 2 1 2 0 2 2 0 0 2 2 2 0
2 2 1 0 1 2 1 1 2 1 1 0 1 1 0
1 2 0 0 0 2 0 2 2 2 0 0 0 0 0
0 2 1 0 1 2 2 1 1 0 1 0 1 0 1
2 0 0 0 2 0 1 1 0 0 2 0 2 2 2
2 1 0 1 1 2 1 1 0 1 1 0 1 1 0
0 2 0 2 2 2 1 0 2 2 1 0 2 2 2
0 1 1 0 1 2 2 2 1 1 1 0 1 1 0
0 0 0 0 0 2 1 0 0 2 0 0 0 2 2
1 2 1 0 1 0 0 2 1 2 1 0 1 2 2
0 0 2 0 1 1 2 0 0 0 2 2 1 2 0
0 2 1 2 2 2 2 2 1 2 1 2 1 0 0
255,218,131
0 2 2 2 0 0 2 0 2 0 2 0 2 0 0
0 1 1 2 1 1 2 1 2 1 1 0 2 1 0
0 0 1 0 1 0 0 1 2 2 1 0 1 1 2
1 2 2 0 0 2 2 1 0 0 1 0 2 0 2
2 2 1 0 1 0 2 0 2 0 1 0 1 2 2
2 0 2 0 1 0 1 1 2 0 2 2 0 2 1
2 1 1 2 1 2 1 1 2 1 1 2 1 0 0
0 2 2 2 2 0 2 2 2 1 0 2 2 2 0
0 2 1 0 1 0 1 1 2 2 1 0 1 1 0
1 2 0 0 2 2 0 1 1 2 0 0 0 2 0
0 0 1 0 1 1 2 0 2 0 1 0 1 2 0
1 2 0 0 0 2 2 1 1 2 1 0 2 0 1
0 2 1 0 1 0 0 2 2 0 2 2 0 0 0
235,255,191
0 0 2 2 2 1 0 2 0 2 2 0 2 0 0
0 1 1 0 1 1 2 1 0 1 1 2 2 1 0
2 2 1 0 1 2 2 1 0 2 1 0 1 1 0
1 0 2 2 0 2 2 0 1 2 0 0 0 2 2
2 0 1 0 1 0 1 2 2 0 1 0 1 2 0
2 0 2 0 1 2 1 1 2 2 2 0 0 2 1
2 1 1 2 1 2 1 1 2 1 0 2 1 2 0
2 0 0 0 2 2 2 2 0 1 2 0 0 2 2
0 0 1 0 1 2 1 1 2 0 1 0 1 1 2
1 2 0 0 2 2 0 1 1 0 0 0 1 2 2
2 2 1 0 1 1 2 0 0 0 1 0 1 2 0
1 2 2 0 2 0 0 1 1 2 1 2 2 0 0
2 2 1 2 1 0 2 2 2 0 0 2 1 2 0
226,199,255
0 1 0 1 2 1 0 2 1 2 2 1 0 2 2
0 2 0 0 0 2 2 1 2 2 2 0 2 1 2
0 1 1 0 1 1 2 1 1 0 1 0 1 1 2
2 2 0 0 1 2 2 2 2 1 0 0 0 2 2
0 1 1 0 1 2 1 2 1 2 1 0 1 1 2
0 0 2 2 2 0 1 1 2 2 2 2 0 1 2
1 2 1 1 0 1 1 1 1 2 1 0 1 1 2
2 2 2 2 0 2 2 0 2 2 1 0 2 2 1
0 1 1 0 1 1 0 1 1 2 1 0 1 2 1
0 2 0 0 2 2 2 0 0 2 0 0 0 2 2
0 1 1 0 1 1 1 1 2 1 1 2 1 2 1
2 0 2 2 2 1 0 2 2 1 2 0 0 0 0
2 1 0 1 2 0 2 1 0 0 0 1 2 1 0
186,193,255
0 0 1 1 2 1 2 2 1 0 0 1 2 2 0
0 2 0 2 2 2 2 1 0 0 2 0 2 1 2
0 1 1 0 1 1 0 1 1 0 1 0 1 1 0
0 2 0 0 2 0 0 2 0 0 0 2 2 2 2
2 1 1 0 1 0 1 2 1 2 1 0 1 1 2
2 2 2 2 0 2 1 1 2 2 0 0 0 1 0
1 0 1 1 2 1 1 1 1 2 1 2 1 1 0
0 0 2 2 0 0 2 0 0 2 1 0 2 0 2
2 1 1 0 1 1 2 1 1 0 1 0 1 0 1
2 0 0 2 0 2 2 2 0 2 0 0 1 2 2
0 1 1 0 1 1 1 1 2 1 0 1 2 2 0
2 2 1 0 2 0 0 2 2 2 2 1 1 2 0
1 2 0 0 1 1 0 2 1 2 0 0 1 0 0
255,203,186
0 0 0 2 2 0 0 2 1 0 0 2 0 2 1
2 1 2 2 1 1 1 1 2 0 1 0 0 1 2
0 0 2 0 1 1 0 0 1 1 2 0 2 1 0
2 0 0 0 0 0 1 2 2 0 0 1 0 1 0
2 0 1 0 1 2 0 2 0 2 2 2 2 1 2
1 1 0 1 2 0 1 1 1 1 0 0 0 2 1
1 1 1 0 0 2 1 1 2 1 2 1 1 1 0
2 2 1 2 1 0 0 1 0 0 0 0 2 1 1
2 2 2 0 1 1 2 2 2 0 2 0 2 1 0
0 1 2 0 0 1 1 2 1 0 0 1 2 0 1
1 1 2 0 2 1 0 0 0 2 2 0 1 1 1
1 1 2 2 0 0 1 1 1 0 1 2 1 1 0
2 2 0 1 1 0 0 1 0 0 1 0 2 0 0
186,211,255